# Syntax Coloring Map For ExampleLibrary
# KEYWORD1 datatypes
# KEYWORD2 methods, functions and instances
# KEYWORD3 structures
# LITERAL1 constants

Mini_Button	KEYWORD1
JC_Button	KEYWORD1
Button	KEYWORD1
ToggleButton	KEYWORD1
AutoRepeatButton	KEYWORD1
LongPressDetector	KEYWORD1
begin	KEYWORD2
read	KEYWORD2
isPressed	KEYWORD2
isReleased	KEYWORD2
wasPressed	KEYWORD2
wasReleased	KEYWORD2
pressedFor	KEYWORD2
releasedFor	KEYWORD2
lastChange	KEYWORD2
changed	KEYWORD2
toggleState	KEYWORD2
